#######
#     #
# #$# #
#  $..#
# $$@.#
#  # .#
#######