########
###   ##
##   $ #
#    $ #
# $@   #
#     ##
##...###
########