#######
##   ##
#. # .#
# $$$ #
#  $@ #
#.###.#
#######